*X***X***X*
*X***X*****
***X***X*X*
XX*XXX*X*X*
***X*******
*X*X*X*XX**
*X***X***X*
*XXXXXXX*X*
*****X***X*
X*XX*X*XXX*
*X***X*X***
*X*XXX***XX
***X***X***
*XXX*XXXXX*
*X***X*****
*X*X*X*XXXX
*X***X***X*
XX*X*XXX*X*
*********X*
*X***XXXXX*
*X*X*X*****
*X*X*X*XXXX
*X*X*X*****
*X*X*X**XX*
*X***X*****
*X*X*XXXXX*
***X*******
*XXX**XXXX*
***********
***XX**XXX*
***X*XXX***
XXXX*X*XXX*
*****X***X*
*X*XXXXX*X*
*X******X**
